

R 900 700

NO ./textures/pickle_rick.xpm
SO./textures/portal.xpm
EA ./textures/vindicators.xpm
WE ./textures/oowee.xpm
S ./textures/rick.xpm
F ./textures/sol.xpm
C ./textures/test.xpm


1 1 1 1 1 1 1 1 1 1 1 1 1 1 1 1 1 1
1 0 0 2 0 0 0 0 0 0 0 0 0 6 0 0 0 1
1 0 0 0 0 0 0 0 0 0 0 0 0 0 0 0 0 1
1 0 0 0 0 0 1 0 0 0 0 0 0 0 0 0 0 1
1 0 0 0 5 0 0 0 0 0 0 0 0 0 0 0 0 1
1 0 0 0 0 0 0 0 0 S 0 0 0 0 0 0 0 1
1 0 0 0 0 0 3 0 0 0 0 0 0 0 0 2 0 1
1 0 0 0 0 0 0 0 0 1 0 0 0 0 0 0 0 1
1 0 0 0 0 0 2 0 0 0 0 0 0 0 0 0 0 1
1 0 0 0 0 0 0 0 0 0 0 0 0 0 0 0 0 1
1 0 0 0 0 0 0 0 0 0 0 0 0 0 0 0 0 1
1 0 0 2 0 0 0 0 0 4 0 0 0 0 0 0 0 1
1 0 0 2 0 0 0 0 0 0 0 0 0 0 0 0 0 1
1 1 1 1 1 111 1 1 1 1 1 1 1 1 1 1




